{
  "tileSize": 12,
  "width": 80,
  "height": 45,
  "tiles": [
    "................................................................................",
    "................................................................................",
    "................................................................................",
    "................................................................................",
    "................................................................................",
    "................................................................................",
    "................................................................................",
    "................................................................................",
    "................................................................................",
    "................................................................................",
    "................................................................................",
    "................................................................................",
    "................................................................................",
    "................................................................................",
    "................................................................................",
    "................................................................................",
    "................................................................................",
    "................................................................................",
    ".............#..................................................................",
    "..............#.................................................................",
    "...............#................................................................",
    "................##..............................................................",
    "..................#.............................................................",
    "..................#.............................................................",
    "..................##............................................................",
    "....................#...........................................................",
    "....................#...........................................................",
    "....................#...........................................................",
    "....................#...........................................................",
    ".....................#..........................................................",
    "......................#.........................................................",
    ".......................#........................................................",
    "........................#.......................................................",
    "........................#.......................................................",
    ".........................#......................................................",
    "..........................#.....................................................",
    "...........................##.....................#.............................",
    "............................##....................##............................",
    ".............................#.....................#............................",
    "..............................##...................#............................",
    "................................#..................#............................",
    ".................................##################.............................",
    "..................................#.#...........................................",
    "................................................................................",
    "................................................................................"
  ],
  "objects": []
}