{
  "tileSize": 12,
  "width": 80,
  "height": 45,
  "tiles": [
    "................................................................................",
    "................................................................................",
    "................................................................................",
    "................................................................................",
    "................................................................................",
    "................................................................................",
    "................................................................................",
    "................................................................................",
    "................................................................................",
    "................................................................................",
    "................................................................................",
    "................................................................................",
    "................................................................................",
    "................................................................................",
    "................................................................................",
    "................................................................................",
    "................................................................................",
    "................................................................................",
    "................................................................................",
    ".........###########################............................................",
    ".........###########################............................................",
    "................................................................................",
    "................................................................................",
    "................................................................................",
    "................................................................................",
    "................................................................................",
    "................................................................................",
    "................................................................................",
    "................................................................................",
    "................................................................................",
    "................................................................................",
    "................................................................................",
    "................................................................................",
    "........................................##############################..........",
    "........................................##############################..........",
    "................................................................................",
    "................................................................................",
    "................................................................................",
    "................................................................................",
    "................................................................................",
    "................................................................................",
    "................................................................................",
    "................................................................................",
    "................................................................................",
    "................................................................................"
  ],
  "objects": [
    {
      "type": "playerSpawn",
      "x": 126,
      "y": 534
    },
    {
      "type": "enemySpawn",
      "x": 174,
      "y": 66
    },
    {
      "type": "enemySpawn",
      "x": 270,
      "y": 102
    },
    {
      "type": "enemySpawn",
      "x": 906,
      "y": 66
    },
    {
      "type": "enemySpawn",
      "x": 882,
      "y": 126
    }
  ]
}