{
  "tileSize": 12,
  "width": 80,
  "height": 45,
  "tiles": [
    "................................................................................",
    "................................................................................",
    "................................................................................",
    "................................................................................",
    "................................................................................",
    "...................################.............................................",
    "................................................................................",
    "................................................................................",
    "................................................................................",
    "................................................................................",
    "................................................................................",
    "................................................................................",
    ".........................................############...........................",
    "................................................................................",
    "................................................................................",
    "................................................................................",
    "................................................................................",
    "................................................................................",
    "................................................................................",
    "................................................................................",
    ".......................................................#############............",
    "................................................................................",
    "................................................................................",
    "................................................................................",
    "................................................................................",
    "................................................................................",
    "................................................................................",
    "................................................................................",
    "..................................##############................................",
    "................................................................................",
    "................................................................................",
    "................................................................................",
    "................................................................................",
    "................................................................................",
    "................................................................................",
    "................................................................................",
    "...........###############......................................................",
    ".........................#......................................................",
    ".........................#......................................................",
    ".........................#......................................................",
    ".........................#......................................................",
    ".........................#......................................................",
    ".........................#......................................................",
    ".........................#......................................................",
    ".........................#......................................................"
  ],
  "objects": [
    {
      "type": "playerSpawn",
      "x": 174,
      "y": 534
    },
    {
      "type": "enemySpawn",
      "x": 702,
      "y": 486
    },
    {
      "type": "enemySpawn",
      "x": 750,
      "y": 486
    },
    {
      "type": "enemySpawn",
      "x": 726,
      "y": 426
    }
  ]
}