{
  "tileSize": 12,
  "width": 80,
  "height": 45,
  "tiles": [
    "................................................................................",
    "................................................................................",
    "................................................................................",
    "................................................................................",
    "................................................................................",
    "................................................................................",
    "...................#....................#.................#.....................",
    "...................#....................#.................#.....................",
    "...................#....................#.................#.....................",
    "...................#....................#.................#.....................",
    "...................#....................#.................#.....................",
    "...................#....................#.................#.....................",
    "...................#....................#.................#.....................",
    "...................#....................#.................#.....................",
    "...................#....................#.................#.....................",
    "...................#....................#.................#.....................",
    "...................#.......#............#.........#.......#.....................",
    "...................#.......#............#.........#.......#.....................",
    "...........................#......................#.......#.....................",
    "...........................#......................#.............................",
    "...........................#......................#.............................",
    "...........................#......................#.............................",
    "...........................#......................#.............................",
    "...........................#......................#.............................",
    "...........................#......................#.............................",
    "................................................................................",
    "................................................................................",
    "................................................................................",
    "................................................................................",
    "................................................................................",
    "..................................#.........#...................................",
    "..................................#.........#...................................",
    "..................................#.........#...................................",
    "..................................#.........#...................................",
    "..................................#.........#...................................",
    "..................................#.........#...................................",
    "..................................#.........#...................................",
    "..................................#.........#...................................",
    "..................................#.........#...................................",
    "................................................................................",
    "................................................................................",
    "................................................................................",
    "................................................................................",
    "................................................................................",
    "................................................................................"
  ],
  "objects": [
    {
      "type": "playerSpawn",
      "x": 126,
      "y": 534
    },
    {
      "type": "enemySpawn",
      "x": 54,
      "y": 114
    },
    {
      "type": "enemySpawn",
      "x": 150,
      "y": 114
    },
    {
      "type": "enemySpawn",
      "x": 102,
      "y": 42
    },
    {
      "type": "enemySpawn",
      "x": 786,
      "y": 150
    },
    {
      "type": "enemySpawn",
      "x": 882,
      "y": 150
    },
    {
      "type": "enemySpawn",
      "x": 834,
      "y": 54
    }
  ]
}